########
#   .  #
#  $$  #
#  #   #
# @ .  #
#      #
########