########
##    ##
##.##$ #
# ..$  #
#  #$  #
#  @ ###
########