#######
#  .#@#
#  $  #
#. $  #
#######