######
# # .#
# $ .#
# @$.#
# $  #
#  ###
######
